10,10,10,10,10,10,10,10,10,10
10,10,10,10,10,10,10,10,10,10
9,14,14,14,14,14,14,14,14,14
9,21,1,1,1,8,1,1,1,1
9,1,8,1,1,1,1,1,1,1
9,1,1,1,1,1,1,8,1,1
9,1,1,1,1,1,1,1,1,1
9,20,20,20,20,20,20,20,20,9
9,20,20,20,20,20,20,20,20,9
9,9,9,9,9,9,9,9,9,9
