10,10,10,10,10,10,10,10,10,10
10,10,10,10,10,10,10,10,10,10
14,14,14,14,14,14,14,14,14,14
1,1,1,1,1,1,1,1,1,1
1,1,1,1,1,1,1,1,1,1
1,1,1,19,1,1,19,1,1,1
1,1,1,1,1,1,1,1,1,1
9,1,1,1,1,1,1,1,1,9
9,1,1,1,1,1,1,1,1,9
9,9,1,1,1,1,1,1,9,9
