10,10,10,10,10,10,10,10,10,10
10,10,10,10,10,10,10,10,10,10
14,14,14,14,14,14,14,14,9,9
1,1,1,1,7,1,14,9,9,9
1,1,1,1,6,1,1,9,9,9
1,1,1,1,1,1,1,1,14,9
1,1,1,1,1,1,1,1,14,9
9,8,1,1,1,1,1,7,14,9
9,8,8,1,1,1,1,6,14,9
9,8,8,8,1,1,1,1,14,9
