9,1,1,1,14,14,1,1,1,9
9,1,8,1,14,14,1,1,1,9
9,1,1,1,14,14,1,1,8,1
9,1,8,1,1,1,1,1,1,1
9,9,1,1,1,1,1,1,1,1
9,9,1,1,1,1,1,1,1,1
9,1,8,1,1,9,1,1,1,1
9,1,8,8,1,1,1,1,1,9
9,8,9,1,1,1,1,9,9,9
9,9,9,9,8,8,9,9,8,9
