9,6,6,6,7,7,6,6,6,9
9,21,1,1,6,6,21,1,1,9
1,1,1,1,1,1,1,1,1,1
1,1,1,1,1,1,1,1,1,14
14,1,1,1,1,14,1,1,1,14
1,14,1,1,1,1,1,1,1,1
1,1,7,1,1,1,1,7,1,1
9,1,6,21,1,1,1,6,21,9
9,1,1,1,1,1,1,1,1,9
9,9,9,9,8,8,9,9,8,9
