9,9,1,1,1,1,1,1,9,9
9,21,1,1,1,1,1,1,1,9
1,1,1,1,1,1,1,1,9,9
1,1,1,1,1,1,1,9,9,9
1,1,1,1,1,1,1,9,9,9
1,14,1,1,1,1,1,8,9,8
1,1,1,1,1,1,1,1,8,8
9,1,8,1,1,1,1,8,8,8
9,9,23,1,23,23,8,1,8,8
9,8,9,23,23,23,23,8,8,9
