8,1,8,8,1,1,1,1,14,9
8,8,1,1,1,1,1,1,8,8
8,1,1,1,1,1,1,1,8,8
8,1,1,1,1,1,7,1,1,9
8,1,1,1,1,1,6,21,9,9
8,1,1,7,1,1,1,1,8,9
8,1,1,6,21,1,1,1,14,9
9,8,1,1,1,1,1,1,14,9
9,8,8,1,1,1,1,1,14,8
8,8,1,1,1,1,1,1,8,8
