18,18,18,18,18,18,18,18,18,18
18,18,21,1,14,14,23,23,8,18
20,20,1,1,14,1,14,23,8,8
20,20,1,1,14,1,14,14,23,23
20,20,1,1,1,1,1,14,14,23
20,20,1,14,1,14,14,14,23,23
20,20,1,1,1,14,1,14,14,23
16,16,17,1,1,1,1,14,17,8
16,16,16,17,17,17,17,17,16,8
16,16,16,16,16,16,16,16,16,8
