8,8,8,23,23,23,23,8,8,8
8,8,23,23,23,23,23,23,8,8
24,24,8,23,23,23,23,23,8,8
23,23,23,23,23,23,23,8,24,8
23,23,23,23,23,23,23,8,8,8
23,23,23,23,23,23,23,23,8,8
23,23,23,23,23,23,23,24,8,8
8,8,23,23,23,23,24,24,24,8
8,8,8,24,24,24,8,8,24,8
8,8,8,8,8,8,8,8,8,8
