8,8,8,1,1,1,1,8,8,8
8,8,1,1,1,1,1,1,8,8
8,1,1,7,1,1,7,1,1,8
8,1,2,6,22,15,6,13,1,8
8,1,3,15,15,15,15,12,1,8
8,1,3,15,15,15,15,12,1,8
8,1,4,15,15,15,15,11,1,8
8,1,1,4,5,5,11,1,1,8
8,8,1,1,1,1,1,1,8,8
8,8,8,8,8,8,8,8,8,8
