9,9,9,9,9,9,9,9,9,9
9,9,1,1,1,1,1,1,9,9
9,1,1,1,1,1,1,1,1,9
9,1,1,2,15,15,13,1,1,9
9,1,1,3,15,15,12,1,1,9
9,1,1,4,5,5,11,1,1,9
9,1,1,1,1,1,1,1,1,9
9,1,8,1,14,14,1,8,1,9
9,1,8,1,14,14,1,8,1,9
9,1,1,1,14,14,1,1,1,9
